1111111111111111111111111111111111
1E0000000000000C00000C000000000001
101001010F100000101001000000010101
1010010010101010001001000000000111
1P0000000C00C000000000000001000001
100000000000F00C00000C000000000001
1010010100100000101001000000010101
101001001010101000100100000101F111
100000F00C00C00F000100000001000001
1111111111111111111111111111111111
