1111111111111111111111111111111111
1E0C00000000000C00000C000010000001
1010010100100000101001000010C101C1
1010010010101010001001001110010101
1P0000000C00C000000000001C100000C1
1111111111111111111111111111111111