1111111111111111111111111111111111
100C00000000000C00000C00000000P001
10100101001000001010010000E0C101C1
1010010010101010001001001100010111
100000000C00C000000000001C000001C1
1111111111111111111111111111111111