1111111111
11010E1101
1000000001
10100C0001
1001C11001
1000101C01
1000101001
1010000CP1
1110000001
1111111111