1111111111111
1F000000P0CE1
1111111111111
